1111111111111111111111111111111111
101000000001000C00000C000000000001
10100101000000001010010000C0010101
1010010010111110001001000000010101
1P00010000000100010000111100000001
100001000000C10001000000C000000001
1000000000000100010000000000000001
100001000000010001001C000000000001
1000010000000100000011110001111001
1000010000000000010000000000000001
1000010000111100010000100000000001
1000010100100100010000100111110001
100000010000010001010010010E000001
1000010100000100010100100000000001
1000000100000100000100100011111111
1000010000100100010000100010000001
1000010000101100010000100010000001
100001000010C1000C0000100010000001
1111111111111111111111111111111111