1111111111
100000001
1111111111