11111111
1P000001
10000C01
1111EE01
11111111