1111111111111
1o0P000000001
111C111110001
1E10000000001
1000000000001
1111111111111