111111111111111111111
100000000000011000001
10000C00000C1000000E1
100000000000000000001
100000000000000001111
100000000000000000011
1P0000000000000000011
10000000000C00C0C0011
100000000000000000001
111111111111111111111