<설명용>

<after>
-1 -1 -1 -1 -1 -1 -1 -1 -1 -1 -1 -1 -1
-1  2  3 -1  5  6  7  8  9 10 11 12 -1
-1  1  2  3  4 -1 -1 -1 -1 -1 12 13 -1
-1  2  1  2 -1 -1 17 16 15 14 13 14 -1
-1 -1 -1 -1 -1 -1 -1 -1 -1 -1 -1 -1 -1

<map1>
-1 -1 -1 -1 -1 -1 -1 -1 -1 -1 -1 -1 -1
-1  0  0 -1  0  0  0  0  0  0  0  C -1
-1  0  0  0  0 -1 -1 -1 -1 -1  0  0 -1
-1  P  0  0 -1 -1  E  0  0  0  0  0 -1
-1 -1 -1 -1 -1 -1 -1 -1 -1 -1 -1 -1 -1